##########
#  #      
#  #     #
#  #     #
#        #
######   #
#        #
#        #
         #
##########

RedDoor,0,8,room4,9,8,KEY11
